palavras que preciso lembrar em ingles:

then - então

them - eles

which -  qual

when - quando

employeed - Empregados

employ - empregado

are  - é

also - também

present - Atualmente

will - vontade

cannot - 

the - o

set - pôr

allow - permitir

allows - permite

allowed - permitido

that - Isso

will be - será (remete ao verbo no futuro)

input - entrada

within - dentro de

without - sem

with - com

specify - especificar

such - tal

should - se

if - se

should be - deve ser

usually - Normalmente

Constraints - Restrições

Restricted - Restrito

  

